000_00000000000000000000000000000000000001						
110_00000000000000000000000000000010000100						
110_00000000000000000000000000000110001000						
100_00000000000000000000000000000110001100						
100_00000000000000000000000000000110010000						
100_00000000000000000000000000000110010100						
110_00000000000000000000000001000110011000						
110_00000000000000000000000011000110011100						
110_00000000000000000000000111000110100000						
100_00000000000000000000000111000110100100						
100_00000000000000000000000111000110101000						
100_00000000000000000000000111000110101100						
100_00000000000000000000000111000110110000						
100_00000000000000000000000111000110110100						
110_00000000000000000100000111000110111000						
100_00000000000000000100000111000110111100						
000_00000000000000000100000111000110111100						
000_00000000000000000100000111000110111100						
000_00000000000000000100000111000110111100						
100_00000000000000000100000111000111000000						
100_00000000000000000100000111000111000100						
100_00000000000000000100000111000111001000						
110_00000000000010000100000111000111001100						
100_00000000000010000100000111000111010000						
110_00000000001010000100000111000111010100						
110_00000000011010000100000111000111011000						
100_00000000011010000100000111000111011100						
100_00000000011010000100000111000111100000						
100_00000000011010000100000111000111100100						
100_00000000011010000100000111000111101000						
110_00001000011010000100000111000111101100						
110_00011000011010000100000111000111110000						
100_00011000011010000100000111000111110100						
100_00011000011010000100000111000111111000						
110_10011000011010000100000111000111111110						
001_10011000011010000100000111000111111110						
000_00000000000000000000000000000000000001						
111_00000000000000000000000000000010000100						
100_00000000000000000000000000000000000100						